###############################
#A  #   #     #       #       #
### # # # # ### ### # # ##### #
#   # #   #     #   # # #   # #
# ### ########### ### # # # # #
#             #   # # # # # # #
########### ### ### # # # ### #
#   #   #   #   #   # # #   # #
# ### # ### # ### # # # # # # #
#   # #   # # #   #   # # #   #
### # ### # # ####### # # #####
# #   #   # #       #   # #   #
# ##### ########### ####### # #
# #   #           #     #   # #
# # # ########### ##### # ### #
# # #   #       # #   #     # #
# # # # # ### ### # # ####### #
#   # # # # #   #   # #       #
# ### ### # ### ##### # ##### #
#   #         #         #    B#
###############################
